####       B#
#### #####  #
#    ##     ##
# ####  ######
  ####       #
        ######
A#############
